5 10
|--------|
|@.##....|
|#.......|
|#.......|
|--------|