5 10
|--------|
|........|
|....@...|
|........|
|--------|