5 10
|--------|
|@.|..#|#|
|..|--.|.|
|........|
|--------|