5 10
|--------|
|@.|...|.|
|..|--.|.|
|........|
|--------|