5 10
|--------|
|@....#.#|
|--------|
|........|
|--------|